1 1 1 1 1 1 1 1 1 1 1 1 1 1 1 1 1 1 1 1 1 1 1 1 1 1 7 7 1 1
1 0 0 1 0 0 0 1 0 0 0 0 0 0 0 1 3 6 0 0 0 0 0 0 0 1 0 0 0 1
1 0 0 1 0 1 0 1 0 0 1 1 3 0 0 0 0 1 0 0 0 0 0 3 4 1 0 6 6 1
1 0 0 1 0 1 0 1 0 0 1 0 1 1 0 0 1 1 0 6 6 6 0 0 0 0 0 0 0 1
1 0 0 0 0 1 0 1 0 0 1 0 0 0 0 1 1 0 0 0 4 0 0 0 0 1 1 1 0 1
1 0 0 0 0 0 0 0 0 0 0 0 0 1 1 0 0 0 0 0 0 0 0 0 0 0 0 1 0 1
1 0 0 1 1 1 1 1 0 0 0 0 0 0 0 4 0 0 0 0 0 0 0 0 0 0 0 1 0 1
1 0 0 1 0 0 0 1 0 0 0 1 1 1 0 0 0 1 0 1 1 1 1 1 1 1 1 1 0 1
1 0 0 0 0 0 0 1 0 0 0 0 3 1 6 6 6 0 0 0 0 0 0 0 0 0 0 0 0 1
1 0 0 1 0 0 0 1 0 0 0 1 1 1 0 0 0 1 0 1 1 1 1 1 1 0 1 1 1 1
1 0 0 1 0 0 0 1 0 0 0 0 0 0 0 0 0 1 0 1 0 3 0 0 0 0 0 0 0 1
1 0 0 1 0 0 0 0 0 0 0 6 6 6 0 0 0 1 0 1 1 1 0 0 0 0 0 0 0 1
1 0 0 1 0 0 1 1 1 6 1 1 1 1 1 1 0 0 0 0 0 0 0 0 0 0 0 0 0 1
1 0 0 1 0 0 0 0 0 0 0 0 0 0 0 1 0 1 6 6 1 1 0 0 0 0 0 0 0 1
1 9 0 1 3 0 0 0 0 0 0 0 0 0 0 0 0 1 5 6 1 0 0 0 0 0 0 8 0 1
1 1 1 1 1 1 1 1 1 1 1 1 1 1 1 1 1 1 1 1 1 1 1 1 1 1 1 1 1 1